NOT FOUND	: les Escaldes
INSERTED at 18	: les Escaldes
FOUND at 18	: les Escaldes
INSERTED at 17	: Andorra la Vella
INSERTED at 8	: Umm al Qaywaynaadf ui mao el derado maikra pavilizei root chain
INSERTED at 9	: Ras al-Khaimah
NOT FOUND	: Dubai
INSERTED at 6	: Khawr Fakkan
INSERTED at 22	: Dubai
FOUND at 22	: Dubai
INSERTED at 3	: Dibba Al-Hisn
INSERTED at 7	: Sharjah
INSERTED at 2	: Ar Ruways
FOUND at 2	: Ar Ruways
INSERTED at 19	: Al Fujayrah
INSERTED at 11	: Al Ain
INSERTED at 10	: Ajman
INSERTED at 4	: Adh Dhayd
INSERTED at 20	: Abu Dhabi
NOT FOUND	: Zaranj
INSERTED at 21	: Zaranj
FOUND at 21	: Zaranj
INSERTED at 5	: Taloqan
INSERTED at 12	: Sabzevar
FOUND at 2	: Ar Ruways
INSERTED at 13	: Shindand
INSERTED at 14	: Elbasan
INSERTED at 15	: Shibirghan
INSERTED at 16	: Shahrak
INSERTED at 0	: Sar-e Pul
INSERTED at 1	: Aibak
NOT FOUND	: Sang-e Charak